type
height 13
width 19
map
.@@@@@@@@@@@@@@@@@@
...................
@@@@@@@@@@@@@@@@@@.
...................
......@@@@@@@@@@@@@
...................
...................
...................
...................
...................
...................
.@@@@@@@@@@@@@@@@@@
...................
