type
height 26
width 76
map
......................................WWWWWWWWWWWWWWWWWWWWWWWWWWWWWWWWWWWWWW
......................................WWWWWWWWWWWWWWWWWWWWWWWWWWWWWWWWWWWWWW
......................................WWWWWWWWWWWWWWWWWWWWWWWWWWWWWWWWWWWWWW
......................................WWWWWWWWWWWWWWWWWWWWWWWWWWWWWWWWWWWWWW
......................................WWWWWWWWWWWWWWWWWWWWWWWWWWWWWWWWWWWWWW
......................................WWWWWWWWWWWWWWWWWWWWWWWWWWWWWWWWWWWWWW
......................................WWWWWWWWWWWWWWWWWWWWWWWWWWWWWWWWWWWWWW
......................................WWWWWWWWWWWWWWWWWWWWWWWWWWWWWWWWWWWWWW
......................................WWWWWWWWWWWWWWWWWWWWWWWWWWWWWWWWWWWWWW
......................................WWWWWWWWWWWWWWWWWWWWWWWWWWWWWWWWWWWWWW
WWWWWWWWWWWWWWWWWWWWWWWWWWWWWWWWWWWWW.......................................
WWWWWWWWWWWWWWWWWWWWWWWWWWWWWWWWWWWWW.......................................
WWWWWWWWWWWWWWWWWWWWWWWWWWWWWWWWWWWWW.......................................
WWWWWWWWWWWWWWWWWWWWWWWWWWWWWWWWWWWWW.......................................
WWWWWWWWWWWWWWWWWWWWWWWWWWWWWWWWWWWWW.......................................
WWWWWWWWWWWWWWWWWWWWWWWWWWWWWWWWWWWWW.......................................
WWWWWWWWWWWWWWWWWWWWWWWWWWWWWWWWWWWWW.......................................
WWWWWWWWWWWWWWWWWWWWWWWWWWWWWWWWWWWWW.......................................
WWWWWWWWWWWWWWWWWWWWWWWWWWWWWWWWWWWWW.......................................
WWWWWWWWWWWWWWWWWWWWWWWWWWWWWWWWWWWWW.WWWWWWWWWWWWWWWWWWWWWWWWWWWWWWWWWWWWWW
......................................WWWWWWWWWWWWWWWWWWWWWWWWWWWWWWWWWWWWWW
......................................WWWWWWWWWWWWWWWWWWWWWWWWWWWWWWWWWWWWWW
......................................WWWWWWWWWWWWWWWWWWWWWWWWWWWWWWWWWWWWWW
......................................WWWWWWWWWWWWWWWWWWWWWWWWWWWWWWWWWWWWWW
......................................WWWWWWWWWWWWWWWWWWWWWWWWWWWWWWWWWWWWWW
......................................WWWWWWW...............................

