type
height 26
width 76
map
@........................@.............................@....@.....@........@
@@@@@@@......@@@@@@@@@@@.@@@@@@@@@@@@...@@@@@........@...@.....@....@@@@...@
@............@.........@..................@...@@@@@@@@@@@@@@@@@@@@@@@...@..@
@...@...@@@@@@...@...@..@@@@@@@@@.@@@@@.@.@......@........@...........@....@
@...@...@....@...@...@................@.@....@...@...@....@...........@@@@@@
@...@......@.....@...@................@......@.......@....@.@@@@@@@@@......@
@...@@@@@@@@@@@@@@@@@@................@@@....@.......@....@@@@@@@@@@@@@@@@.@
@..............@.......@@@@@@@@@@@@...@...@@.@.......@....@................@
@...@@@@@@@@@..@......................@................@@.@.@@@@@@@@@@@@@@@@
@...........@..@...........@@@@@@@@@@@@@@...@@@@@@@@@@@...@................@
@.@@@@@@@@@@@..@.@@@@@@@@@@@@...@....@@...@@.@.......@....@@@@@@@@@@@@@@@@.@
@..............@..............@...@..@@@@..@..@.....@..@@@@................@
@@@@@@..@@@@@@@@@@@@@@@@@@@@@@@@@@@.@@@...@@....@@@...@...@@@@@@..@@@@@@@@@@
@.....@.@.............................@.................@.......@..........@
@.@.@.@.@.............@@@@@@@@@@@@@@@@@@@@@@@@@@@@@@@@@@@@@@@@@@@@@@@@@@@@.@
@.@.@...@.................@...@...@...@...@.........@.....@.....@..........@
@.@.@@@@@..............@..@.@.@.@.@.@.@.@.@....@....@..@..@.@@@.@.@@@@@@@@@@
@.@....@@..............@....@...@...@...@......@.......@....@...@..........@
@.@@@@..@..@@@@@@@@@@@@@@@@@@@@@@@@@@@@@@@@.@@@@@@@@@@@@@@@@@@@.@@@@@@@@@@.@
@@......@.....@.....@@@@.....@@@@@@@@@@@@@@.....@...............@..........@
@..@@@@@@.....@......@...@@@...@......@@@.......@......@.@@@@@@@@@.@@@@@@..@
@.............@......@..@...@..@...@.@...@......@......@.........@......@..@
@.@@@@@@@@@@@@@......@..@@@@@......@.@@@@@......@.............@......@.....@
@....@..@...@...@.@..@..@...@...@.@......@@@@@@@@@@@@@@@@@@@@@@@@@@@@@@@@@.@
@..@..@...@...@....@....@...@....@...@.....................................@
@@@@@@@@@@@@@@@@@@@@@@@@@@@@@@@@@@@@@@@@@@@@@@@@@@@@@@@@@@@@@@@@@@@@@@@@@@..


